2,2,2,2,2,2,11,2,2
0,0,0,0,0,0,0,0,0
0,0,7,0,7,0,0,0,0
0,0,0,0,0,0,0,0,0
0,0,7,0,0,0,7,0,0
0,0,0,0,0,0,0,0,0
0,0,0,0,7,0,7,0,0
0,0,0,0,3,0,3,0,0
0,0,7,0,3,0,7,0,0
0,0,0,0,3,0,3,0,0
0,0,7,0,7,0,3,0,0
0,0,0,0,0,0,3,0,0
1,1,1,1,1,1,10,1,1
